png/boardtexture.png

0 0 400 400
1200 0 400 400

2

png/p2.png 700 930 1 2
png/p1.png 700 930 18 15

400 0 400 400
800 0 400 400

16 20

-2  -2  -2  -2  -2  -2  -2  -2  -2  -2  -2  -2  -2  -2  -2  -2  -2  -2  -2  -2
-2  -1   0  -1  -1  -1  -1  -1  -1  -1  -1   1  -1   1  -1  -1  -1  -1  -1  -2
-2  -1   0  -1  -1  -1  -1  -1  -1  -1  -1  -1  -1   1  -1  -1  -1   1  -1  -2
-2  -1  -1  -1  -1  -1   0  -1  -1  -1  -1  -1  -1   1  -1  -1  -1  -1  -1  -2
-2  -1  -1   0  -1   0  -1  -1   0  -1  -1  -1  -1   1  -1  -1   1  -1  -1  -2
-2  -1  -1   0  -1   0  -1  -1   0  -1  -1  -1  -1  -1  -1  -1   1  -1  -1  -2
-2  -1  -1  -1  -1   0  -1  -1   0  -1  -1  -1  -1  -1  -1  -1   1  -1  -1  -2
-2  -1  -1  -1  -1   0  -1  -1   0  -1  -1   1  -1  -1  -1  -1  -1  -1  -1  -2
-2  -1   0  -1  -1   0  -1  -1  -1  -1  -1   1  -1  -1  -1  -1   1  -1  -1  -2
-2  -1   0  -1  -1   0  -1  -1  -1  -1  -1   1  -1   1  -1  -1   1  -1  -1  -2
-2  -1  -1  -1   0   0  -1  -1  -1  -1  -1   1  -1   1  -1  -1   1  -1  -1  -2
-2  -1  -1  -1  -1   0  -1  -1  -1  -1  -1  -1  -1   1  -1  -1   1  -1  -1  -2
-2  -1   0  -1  -1  -1  -1  -1  -1  -1  -1  -1  -1  -1  -1  -1  -1  -1  -1  -2
-2  -1   0  -1  -1  -1  -1  -1  -1  -1  -1  -1  -1  -1  -1   1  -1  -1  -1  -2
-2  -1  -1  -1  -1  -1  -1  -1   0  -1  -1  -1  -1  -1  -1   1  -1   1  -1  -2
-2  -2  -2  -2  -2  -2  -2  -2  -2  -2  -2  -2  -2  -2  -2  -2  -2  -2  -2  -2